NO                 textures/north.xpm
C 3,198,192
EA       textures/east.xpm
F               170,170,170
WE                      textures/west.xpm
SO  textures/south.xpm

SP textures/sprite.xpm
DR textures/door.xpm

111
1S1                         1111111
10111111                    111O111
100D0001                    1100011
111111D1                    1000001
1O000D0111111111111111111   1000001
1111110D0000100000D000001   1000001
     101000010111111111011  1011111
     1010000001  111 1000111101
  1111010000101  1O1 1000000001
  1O00011111101111D111O00111011
  1111000000D00000000D0001 101
     101111111110111111011 101
     101    1O0001    101  101
     1011111100001111110111101
     1000000000000000000000001
     1000000000000000000000001
     1000000000000000000000001
     1111111111111111111111111