NO                 textures/north.xpm
C 3,198,192
EA       textures/east.xpm
F               170,170,170
WE                      textures/west.xpm
SO  textures/south.xpm

SP textures/sprite.xpm
DR textures/door.xpm

11111
1OOO1
10NO1
1O001
10OO1
1OO01
11111