NO                 textures/north.xpm
C 3,198,192
EA       textures/east.xpm
F               170,170,170
WE                      textures/west.xpm
SO  textures/south.xpm

11111
10001
10S01
10001
11111