NO                 textures/north.xpm
C 190,254,23
EA       textures/east.xpm
F               0,5,0
WE                      textures/west.xpm
SO  textures/south.xpm

11111
10001
10N01
10001
11111