NO          textures/north.xpm
SO          textures/south.xpm


C   190,254,23


EA          textures/south.xpm
WE          textures/south.xpm

F 75,75,75,,,


11111111111111111111
10000000000000000001
1000000N000000000001
10000000000000000001
11111111111111110001
               10001
               11111
