NO          textures/north.xpm
SO          textures/south.xpm

C   190,254,23
EA          textures/south.xpm

F              0,5,0

WE          textures/south.xpm

11111
101011111
111111001
    1N111