NO                 textures/north.xpm
C 190,254,23
EA       textures/east.xpm
F               0,5,0
WE                      textures/west.xpm
SO  textures/south.xpm

111111111111
1000000001
10W0111101
1000000101
111111111111
1 1 11