NO ./textures/minecraft/brick.xpm
SO ./textures/minecraft/tnt.xpm
WE ./textures/minecraft/diamond_ore.xpm
EA ./textures/minecraft/sand.xpm

F 255,0,255
C 100,50,200

111111111111111
110000000000011
101000000000001
10010000000S001
100010000000001
100001000000001
100000100000001
100000000000001
100000001000001
100000000100001
100000000010011
100001000001001
100000000000101
110000000000011
111111111111111