NO textures/north.xpm
SO textures/south.xpm
WE textures/west.xpm
EA textures/east.xpm

C 165,162,158
F 136,134,130

1111111111111111111111111
1000000000110000000000001
1011000001110000000000001
1001000000000000000000001
1111111110110000011100001
1000000000110000000000001    1111111111111
1000000000000000000000001    1000000000001
100000000000000000000000111111000000000001111111
10000000000000000000000000000000000000000000N001
100000000000000000000000111111000000000001111111
1000000000000000000000001    1000000000001
1111111111111111111111111    1111111111111
