NO                 textures/wolf3d/north.xpm
C 3,198,192
EA       textures/wolf3d/east.xpm
F               170,170,170
WE                      textures/wolf3d/west.xpm
SO  textures/wolf3d/south.xpm

11111111111111111111111111111111111111111111111111111
10000000000000000000000000000000000000000000000000001
10100010001000100010001000100010001000100010001000101
10001000100010001000100010001000100010001000100010001
10100010001000100010001000100010001000100010001000101
10001000100010001000100010001000100010001000100010001
10100010001000100010001000100010001000100010001000101
10001000100010001000100010001000100010001000100010001
10100010001000100010001000100010001000100010001000101
10001000100010001000100010001000100010001000100010001
10100010001000100010001000100010001000100010001000101
10001000100010001000100010001000100010001000100010001
10100010001000100010001000100010001000100010001000101
10001000100010001000100010001000100010001000100010001
101000100010001000100010W0100010001000100010001000101
10001000100010001000100010001000100010001000100010001
10100010001000100010001000100010001000100010001000101
10001000100010001000100010001000100010001000100010001
10100010001000100010001000100010001000100010001000101
10001000100010001000100010001000100010001000100010001
10100010001000100010001000100010001000100010001000101
10001000100010001000100010001000100010001000100010001
10100010001000100010001000100010001000100010001000101
10001000100010001000100010001000100010001000100010001
10100010001000100010001000100010001000100010001000101
10001000100010001000100010001000100010001000100010001
10000000000000000000000000000000000000000000000000001
11111111111111111111111111111111111111111111111111111