NO ./resources/cpeset-c.xpm
SO ./resources/alajara-.xpm
WE ./resources/eralonso.xpm
EA ./resources/frankgar.xpm
F    0,255,0
C    255,0,255

1111111
1000001
10N0001
1000001
1111111