NO ./resources/cpeset-c.xpm
SO ./resources/alajara-.xpm
WE ./resources/eralonso.xpm
EA ./resources/frankgar.xpm
F    0,255,0
C    255,0,255

111111
100001
100W01
100001
111111