NO ./resources/Wooden_Floor_Horizontal.xpm
SO ./resources/Wooden_Floor_Horizontal.xpm
WE ./resources/Wooden_Floor_Horizontal.xpm
EA ./resources/Wooden_Floor_Horizontal.xpm

C 171,118,30
F 194,144,63

111111111111111111111
100000000000000000001
100000000000000000001
100011000000000110001
1000110000N0000110001
100000000000000000001
100000000000000000001
100000000000000000001
100000000000000000001
111111111111111111111
