NO                 textures/test/bloquexculo.xpm
C 28,28,36
EA       textures/test/bloquexculo.xpm
F               44,43,59
WE                      textures/test/bloquexculo.xpm
SO  textures/test/bloquexculo.xpm

SP                   0,0,0           1   1      textures/test/damnatus_test/
DR textures/wolf3d/door.xpm

111111
111101
101011                      1111111
10011111                    111O111
100D0001                    1100011
111111D1                    1000001
1O000D0111111111111111111   1000001
1111110D0000100000D000001   1000001
     101000010111111111011  1011111
     1010000001  111 1000111101
  1111010000101  1O1 1000000001
  1O00011111101111D111O00111011     111111
  1111000000D00000000D0001 101      10O001
     101111111110111111011 101      100001
     101    1O0001    101  101     1100001
     10111111000011111101111011   11000001
     1000000000000000000000000111110000011
     1000N000000O00000000000000000D000011
    110000000000000000000O00000000D00011
   110011111111111111111111111111111111
   11111                      1
11111011                       1
11110111                        1
11101111
11111111