EA textures/doom/STARGR2.xpm
NO textures/doom/STARG3.xpm
SO textures/doom/BROWN1.xpm
WE textures/doom/STARTAN3.xpm
F 25,30,25
C 190,160,150
DR textures/doom/BIGDOOR2.xpm
SP 0,255,255 17 12 textures/doom/enemy/


                  1111111111
 11111            1000000001
110001 11111111   1000000O0111
10000111000000111110O000000D01
10E00000000000D000000000000101
100001110000001111100000000101
11000D011111111   10000O000101
 1111101          100000000101
     101          1111111111D1111
     10111111111        100000001
     10000000001        100000001
     1111100D001        1000O0001
         10DOD01        100111111
         100D001        1001
         1000001        10O1
         111D111111111111001
         100000000000000D001
         100O00000000000D001
         1111111111111111111