NO                 textures/wolf3d/north.xpm
C 3,198,192
EA       textures/wolf3d/east.xpm
F               4,135,99
WE                      textures/wolf3d/west.xpm
SO  textures/wolf3d/south.xpm

SP                   0,0,0           12   3      textures/ninot/
DR textures/wolf3d/door.xpm

111111
111101
1S1011                      1111111
10011111                    111O111
1O0D0001                    1100011
111111D1                    1000001
1O000D0111111111111111111   1000001
1111110D0000100000D000001   1000001
     101000010111111111011  1011111
     1O10000001  111 1000111101
  1111O10000101  1O1 1000000001
  1O00O11111101111D111O00111011
  1111O00000D00000000D0001 101
     1O1111111110111111011 101
     101    1O0001    101  101
     1011111100001111110111101
     1000000000000000000000001
     10000000000O0000000000001
    11000000000000000000000001
   110011111111111111111111111
   11111                      1
11111011                       1
11110111                        1
11101111
11111111