NO ./textures/wolf3d/north.xpm
SO ./textures/wolf3d/south.xpm
WE ./textures/wolf3d/west.xpm
EA ./textures/wolf3d/east.xpm
F 220,100,0
C 225,30,0
DR ./textures/wolf3d/door.xpm
SP 0,0,0 1 100 ./textures/wolf3d/barrel/

        1111111111111111111111111
        1000000000110000000000001
        10110000011100O0000O00001
        1001000000D00000000000001
111111111011000001110000000000001
1000000000110O000111D11111D111111
11110111111111011100000010001
11110111111111011101010010001
1100000011010101110000001OOO1
10O00000000000001100000010001
1000O000000000001101010010001
110000011101O1011111011110N0111
11110111 1110101 101111010001
11111111 1111111 111111111111