SO         textures/wolf3d/south.xpm

C 3,198,192



NO textures/wolf3d/north.xpm


EA  textures/wolf3d/east.xpm


F       4,135,99


























WE     textures/wolf3d/west.xpm
DR              textures/wolf3d/door.xpm
SP 99,116,125                  1 13 textures/wolf3d/enemy/
                             111111111111111
                             111111111111111
                             100000000000111111
     111111      11111111111110000O000000111111
     100001      100000000000100000000000100011
     1000011     100000000000D0000000000OD0O011
     1000001     100000000000100000000000100011
     1000001     100011111111100000000000111111
     11111111111 10001       100000000000111111
     10000000001 10001       111111D1111111
     100000000O111000111     11111000111111
     100O0000001000O0001       1110O0111111
     1000000O00D00000001       11100011
     1000000000100000O01       11100011
11111100O000000111111111   11111110001111
11111100000000O1           11111110001111
1000111111D11111           1100DO00000O11
1000111110001              11001110001111
10001   10001              11001110001111
11D11   10001              11001110001111
1000111110001              111111100011
1000100010001              111111100011
1000000O10001            11111111D11111111          1111111111
1000100010O01            11111100000111111          1000000001
1000111111D11111         10000000000000001          1000000001
100011O000000001         100000000000000011111111111100000O001
1000110000000001         1000000000000000010000000001000000001
1000110000000001         100000000000O0000D000000000D000000001
1000010000000001         1000000000000000010000000001000000001
10000D0O00000001         10000000000000001111000011110000000O1
1000010000000001         10000000000000001  110011  1000000001
1000110000000001         11111100000111111   1001   1000000001
1000110000000001         11111111D11111111   1001   1111111111
1000110000000O01               10001         1001
1000111111D11111               10001         1001
10001   10001                  10001         1001
1000111110001                  10001         10O1111111111111
1000100010001                  10001         1001100100000111
1000000010001                  10001         1000100000000011
1000100010001                  10O01         1000D00000000011
1000111110001                  10001         10O0100000000011
10O0111110O01111111111111      10001         1111100101010111
10000000000000000100000O1111   10001         1111111111111111
10000000000000000D000O000001   10001
10000000000000000100000O111111111D11111111
111111111111111111D11111111000010001000011
         111001001001    110000D000D000011
         1000010010O1    11000010001000011
         111000001111    11000010001000011
           11D1111       11111110001111111
            1001         11000010001000011
            1001         110E00D000D000011
            1111         11000010001000011
                         11111110001111111
                         11000000000000011
                         1100000000000O011
                         11O00000000000011
                         11111111111111111
